// ┌────────┬────────┬────────┬────────┬────────┬────────┬────────┐        ┌────────┬────────┬────────┬────────┬────────┬────────┬────────┬────────┬────────┐
    _______ ,_______ ,_______ ,_______ ,_______ ,_______ ,_______ ,         _______ ,_______ ,_______ ,_______ ,_______ ,_______ ,_______ ,_______ ,_______ ,
// ├────────┴────┬───┴────┬───┴────┬───┴────┬───┴────┬───┴────┬───┘    ┌───┴────┬───┴────┬───┴────┬───┴────┬───┴────┬───┴────┬───┴────┬───┴────────┼────────┤
    _______      ,_______ ,_______ ,_______ ,_______ ,_______ ,         _______ ,_______ ,_______ ,_______ ,_______ ,_______ ,_______ ,_______     ,_______ ,
// ├─────────────┴─┬──────┴─┬──────┴─┬──────┴─┬──────┴─┬──────┴─┐      └─┬──────┴─┬──────┴─┬──────┴─┬──────┴─┬──────┴─┬──────┴─┬──────┴────────────┼────────┤
    _______        ,_______ ,_______ ,_______ ,_______ ,_______ ,         _______ ,_______ ,_______ ,_______ ,_______ ,_______ ,_______            ,_______ ,
// ├───────────────┴─────┬──┴─────┬──┴─────┬──┴─────┬──┴─────┬──┴─────┐  └─────┬──┴─────┬──┴─────┬──┴─────┬──┴─────┬──┴─────┬──┴───────────────────┼────────┤
    _______              ,_______ ,_______ ,_______ ,_______ ,_______ ,         _______ ,_______ ,_______ ,_______ ,_______ ,_______ ,_______      ,_______ ,
// ├──────────┬──────────┴┬───────┴──┬─────┴─────┬──┴────────┴────────┤        ├────────┼────────┴────┬───┴────┬───┴────┬───┴────┬────────┬────────┼────────┤
    _______   ,_______    ,_______   ,_______    ,_______             ,         _______ ,_______      ,_______ ,_______ ,_______ ,_______ ,_______ ,_______
// └──────────┴───────────┴──────────┴───────────┴────────────────────┘        └────────┴─────────────┴────────┴────────┴────────┴────────┴────────┴────────┘
